#################################
#...............................#
#...............................#
#.....................S.........#
#....................HS.........#
#....................SS.........#
#...............................#
#.....A.........................#
#...............................#
#################################