##########....################..........
#........#....#..............#..........
#........#....#..............#..........
#..................................J....
#........#....#..............#..........
#.......A#....#..............#..........
#........#....#..............#..........
#........#....#..............#..........
#........#....#..............#..........
#........#....#..............#..........
########.#....#..............#..........
..............#..............#..........
..............#..............#..........
..............#..............#..........
..............#..............#..........
..............#..............#..........
..............#..............#..........
..............#..............#..........
..............#..............#..........
..............######.#########..........
....................................H...
........................................
