########....###############
#......#....#.............#
#......#....#.............#
#......#....#.............#
#.........................#
#####.##....#.............#
............#.............#
............#.............#
............#.............#
............#.............#
............#.............#
............####.##########
#####.##########.########..
#..........##...........#..
#..........................
#..........##...........#..
#..........##...........#..
#..........#####.########..
#..........#...............
#..........#...............
#.....A....#...............
#..........#...............
#..........#...............
#####.######...............
#####.##....####.########..
#......#....#...........#..
#......#....#...........#..
#......#....#...........#..
#..........................
#......#....#...........#..
#......#....#...........#..
#......#....#...........#..
#......#....####.########..
#......#...................
#......#...................
#......#...................
#......#...................
#......#...................
#####.##...................
...........................
...........................
.....................H.....
..J........................
...........................
...........................
...........................
...........................
