#................................................
#.....##.....##.....##...#..#.....##...#..#...#..
#.....##.....##.....##...#..#.....##...#..#...#..
#.....##.....##.....##...#..#.....##...#..#...#..
####.###.....##.....##.###..#.....##...#..#####..
.......#.....##.....#.......#.....##...#.........
.......#.##.######.##.......####.#####.#.........
####...#.##.######...#.###.#####.#####.#..#####..
#......#.....##......#.....##.....##...#..#...#..
#..............................................A.
#................................................
####...#.....#####...#.....##.....####.#..#####..
.......#.....#.......#.....##.....#..............
.......#.##.##.......#.###.#####.##..............
####.###.##...####...#.###.#####...###.#.######..
#.....##......#......#.....##......#.....##...#..
#.....##......#......#.....##......#.....##...#..
#.....##......#......#.....##......#.....##...#..
#..H..##.##...####...#.....##......#.....##...#..
#................................................
#.........................................J......
####...#.##.######.###.###.#####...###.#.######..
#......#.....##.....##.....##......#.....##...#..
#......#.....##.....##.....##......#.....##...#..
#......#.....##.....##.....##......#.....##...#..
####...#.##.###.....##.....#####...###.#.##...#..
..............#.....##.....#..............#...#..
..............####.###.###.#..............#####..
#...............................................#
#.....##.....##.....##.....##.....##.....##.....#
#.....##.....##.....##.....##.....##.....##.....#
#.....##.....##.....##.....##.....##.....##.....#
#.....##.....##.....##.....##.....##.....##.....#
#...............................................#
#.....##.....##.....##.....##.....##.....##.....#
#.....##.....#####.###.....##.....##.....##.....#
####.###.....#.......#.....##.....##.....##.....#
.......#.....#.......#.....##.....##.....##.....#
.......#######.......############################
