#################################
#.........................H.....#
#...............................#
#..........T....................#
#....T..........................#
#.............T.................#
#..........................T....#
#.....A.........................#
#...............................#
#################################