Left
##################
#         S     A#
#    ##  HS      #
#        SS    ###
##################