###########################
#........##...............#
#........##...............#
#........##...............#
#........##...............#
#........##..........H....#
#........##...............#
#........##...............#
#........##...............#
#........##...............#
#.........................#
#.J......##...............#
#........##..........A....#
#........##...............#
###########################
