###############
#.....##......#
#.............#
#.....##......#
#.....####.####
#.J...#........
##.####........
##.##..###.####
#...#..#......#
#.............#
#...#..#.....T#
#...#..###.####
#...#...H......
##.##..........
##.#######.####
#.....##......#
#.....##......#
#.........A...#
#.....##......#
#.....##......#
##.#######.####
##.#######.##..
#..............
#.....##.T..#..
#.....##....#..
#.....##....#..
#.....##....#..
#############..
