#################################
#.........................H.....#
#...............................#
#...............................#
#...............................#
#...............................#
#...............................#
#.....A.........................#
#...............................#
#################################