-1 0
##################
#          S     #
#    ####        #
#              ###
# A              #
#        ###     #
#                #
##################