#################################
#.........................H.....#
#...............................#
#..........T....................#
#...............................#
#.............J.................#
#..........................T....#
#.....A.........................#
#...............................#
#################################