#################################
#...H...........................#
#...............................#
#...............................#
#...............................#
#...............................#
#...............................#
#.............A.................#
#...............................#
#################################