#################################
#...............................#
#...............................#
#............T............T.....#
#.........................H.....#
#.............J.................#
#...............................#
#.....A.........................#
#...............................#
#################################