down
#################################
#                         H     #
#                               #
#                               #
#                               #
#                               #
#                               #
#     A                         #
#                               #
#################################