..........##..........##
.#######################
.#####.##.##.####..##.##
.#####.##.##.####..##.##
.#####.##.##.####..##.##
.#######################
.#..##....##.#..#......#
.##.##.##.##.####..#####
.##.##.##.##.####..#####
.##.##.##.##.####..#####
.##.##.##.##.####..#####
.#######################
.#...#....#..#..#......#
.#####.####..####..#####
.#####.####..####..#####
.#######################
.#######################
.#...#....#..#..#......#
.#...#....#..#..#.....##
.#####.####..####..##.##
.#####.####..####..##.##
.#####.####..####.....##
.#######################
.#...#....#..#..#.######
.#...#....#..#..#......#
.#####.####..####..#####
.#####.####..####..#####
.#######################
######.####..####..#####
########################
.#..##....#..#..#......#
.##.##.####..####..#####
.##.##.####..####..#####
.##.##.####..####..#####
.#######################
.##.##.####..####..#####
.#..##.####..####..#####
######.####..####..#####
######..........H..A....