#####..#####..####################
#...#......#..#.....##...........#
#.................J..............#
#...#......#..#.....##...........#
##.##...####..#.....##...........#
..............#.....##...........#
..............###.####.#####.#####
##.####.####.####.#..#.#####.#####
#................................#
#.....#......##...#..#...........#
#.....#......##...#..#...........#
#.....#......####.#..#...........#
#................................#
##.####.####.#.......#.#####.#####
##.##...####..###.####.#####.#####
#...#......#..#.....##...........#
#...#......#..#.....##...........#
#................................#
#...#...####..#.....##...........#
#...#.........#.....##...........#
##.##.........###.####.#####.#####
##.##A..####.####.#..#.#####.#####
#................................#
#...#........##...#H.#...........#
#...#........##...#..#...........#
#...#........##...#..#...........#
#...#........##...#..#...........#
#................................#
##.##...####.####.#..#.#####.#####
..................................
..................................
