#################################
#                               #
#                               #
#                     S         #
#                    HS         #
#                    SS         #
#                               #
#     A                         #
#                               #
#################################