##################
#..........S.....#
#....####........#
#..............###
#.A..............#
#........###.....#
#................#
##################